# Arda Keywords

# Classes (KEYWORD1)
Arda	KEYWORD1
TaskState	KEYWORD1
ArdaError	KEYWORD1
StopResult	KEYWORD1
TraceEvent	KEYWORD1

# Methods (KEYWORD2)
createTask	KEYWORD2
deleteTask	KEYWORD2
startTask	KEYWORD2
pauseTask	KEYWORD2
resumeTask	KEYWORD2
stopTask	KEYWORD2
setTaskInterval	KEYWORD2
setTaskTimeout	KEYWORD2
getTaskTimeout	KEYWORD2
findTaskByName	KEYWORD2
renameTask	KEYWORD2
startTasks	KEYWORD2
stopTasks	KEYWORD2
pauseTasks	KEYWORD2
resumeTasks	KEYWORD2
startAllTasks	KEYWORD2
stopAllTasks	KEYWORD2
pauseAllTasks	KEYWORD2
resumeAllTasks	KEYWORD2
begin	KEYWORD2
run	KEYWORD2
reset	KEYWORD2
hasBegun	KEYWORD2
setTimeoutCallback	KEYWORD2
setStartFailureCallback	KEYWORD2
setTraceCallback	KEYWORD2
getTaskCount	KEYWORD2
getMaxTasks	KEYWORD2
getTaskName	KEYWORD2
getTaskState	KEYWORD2
getTaskRunCount	KEYWORD2
getTaskInterval	KEYWORD2
getCurrentTask	KEYWORD2
isValidTask	KEYWORD2
isTaskYielded	KEYWORD2
getValidTaskIds	KEYWORD2
hasTaskSetup	KEYWORD2
hasTaskLoop	KEYWORD2
hasTaskTeardown	KEYWORD2
yield	KEYWORD2
uptime	KEYWORD2
getError	KEYWORD2
clearError	KEYWORD2
errorString	KEYWORD2

# Constants (LITERAL1)
ARDA_VERSION_MAJOR	LITERAL1
ARDA_VERSION_MINOR	LITERAL1
ARDA_VERSION_PATCH	LITERAL1
ARDA_VERSION_STRING	LITERAL1
ARDA_MAX_TASKS	LITERAL1
ARDA_MAX_NAME_LEN	LITERAL1
ARDA_MAX_CALLBACK_DEPTH	LITERAL1

# Macros (KEYWORD2)
TASK_SETUP	KEYWORD2
TASK_LOOP	KEYWORD2
TASK_TEARDOWN	KEYWORD2
REGISTER_TASK	KEYWORD2
REGISTER_TASK_WITH_TEARDOWN	KEYWORD2
REGISTER_TASK_ID	KEYWORD2
REGISTER_TASK_ID_WITH_TEARDOWN	KEYWORD2
REGISTER_TASK_ON	KEYWORD2
REGISTER_TASK_ON_WITH_TEARDOWN	KEYWORD2
REGISTER_TASK_ID_ON	KEYWORD2
REGISTER_TASK_ID_ON_WITH_TEARDOWN	KEYWORD2

# Global instance
OS	KEYWORD1
